###############################################################################################
||..  .............................................................................    ......  ||
||..  %%%%%%%%%%%%%%%%%%%%%%%%%%%%%%%%%%%%           ...   %%%%%%%%%%%%%%%%  |%| ..     %%%%   ||
||..                       |G          |%|        |%|...   |            |%|  |%| ..      |%|   ||
||..                       |           |%|        |%|...   |G           |%|  |%| ..      |%|   ||
||..                       %%%%%%%%%%%%%%   .  .  |%|...   %%%%%%%%%%%%%%%%      ..      %%  . ||
||..                       |%|              .  .  |%|...   ................. |%| ..          . ||
||..                       %%%%%%%%%%%%%%%%%.  .  |%|...   %%%%%%%%%%%%%%    |%| ..      %%%%. ||
||..                                     |%|.              |%|........       |%| ..       |%|. ||
||..                    ...............  |%|.              |%|........|%|        ..       |%|. ||
||..|%|               |%|%%%%%%%%%%|%|.  |%|. |%|          |%|........|%|        ..|%|    |%|. ||
||..|%|               |%|          |%|.. |%|. %%%%%%%%%%%%%%  ......G.|%|         .|%|.   |%|. ||
||..|%|               |%|    P     |%|..              ...|%|       %%%%%%        . |%|.   |%|. ||
||..|%|                                .              ...|%|                 |%| ..|%|.        ||
||..|%|               %%%%%%%%%%%%%%%%%%%%%%%         ...|%|%%%%%%%%%%%%     |%| ..|%|%%%%%%%% ||
||........................................................................   |%| ............. ||
||  ......................................................................         ........... ||
||..|%|               |%|    |%|..            %%%%%%%%%%%%%%   .......|%|    |%| ..|%|.        ||
||..|%|               |%|    |%|..                    ...|%|      %%%%%%%    |%| ..|%|.        ||
||..|%|                          .                    ...|%|                 |%| ..|%|.        ||
||..|%|               %%%%%%%%%%%%%%%%%%%%%%%         ...|%|%%%%%%%%%%%%     |%| ..|%|%%%%%%%% ||
||........................................................................   |%| ............. ||
||  ......................................................................         ........... ||
  ###############################################################################################